............................................
.........................#..##..............
.......########.............................
............................................
............................................
.............................##.............
..#.........................................
..#...............#####.....................
..#.........................................
..#..........##..................#..........
..#.........................................
############################################
############################################
############################################
############################################
............................................
.........####............#..................
............................................
............................................
............................................
............................................
............................................
............................................
............................................