............................................
.........................#..##..............
.......########.............................
............................................
............................................
.............................##.............
............................................
..................#####.....................
............................................
.............##..................#..........
............................................
############################################
............................................
.........####............#..................
............................................
............................................
............................................
............................................
............................................
............................................
............................................